11111111111111111111111111
10010000000C000010000000C1
10000111110000000011111001
1P0011E0C000000001100C0001
11111111111111111111111111